    #####################################
    #     *   $.  $.    *   $.  *       #
  ### **.*.  *.*  .*  **.  *.*  .*.*.*  ###
  #     $ $ * $ * $     $ * $ * $ $ $     #
### ## ############## ################ ## ###
#   ##  * * * * * $ *   * * * * * * .   #   #
# @ ### #   #    .# ## ## #     #  $# #*  * #
#.* #     #######           #######     # * #
#$.$# # #$    #  *# # # # #*  #    .# # #$. #
#   # #   * * * *   * * *   * * * * $ . # * #
#  *#$## *##$#$##* ### ### *##$#$##* # *#$.*#
#.* #  #  #. . .#  #    .#  #. . .#  #  #   #
#$.$# $##*$ #$# $* #$* $.##*$ .$# $* ##*#*  #
# * #  #  #... .#  #. $# #  #... .#  #  # * #
#  *#* # *$ #$#  *## *   # *$ #$# $*## *#$.$#
#   #..#  #. .  #  #  ####  #. .  #  #  # *.#
#*.$#### *##$#$##* ####### *##$#$##* # *#*  #
# * # .   * * * *   * * * * * * * * $   #   #
# .$#$# #*  #    *# # # # #     #  .# #*#$.$#
# * #     #######   $ $ $   #######     # *.#
# .$#*# # #    .#*#.  $  .#*#   .##*# ###   #
# * # # # .$ # .#   #.#.    #   ###   #     #
# * #   #*#   $.#*#.$*#*$.#*# $ $  *#   # * #
#     #   # #$$ # #  .*.    # .$$.#   ### * #
#   #*# #*#   #   #.  $ #.#*#  # .#*# ###$.*#
#.* #     #######   $ $ $   #######     #   #
#$.$#*# #.  #     # # # # #     #  $# #*#*  #
#   #   $ * * * * * * * * * * * * * .   # * #
#  *#* # *##$#$##* # ##### *##$#$##* # *#$.$#
#.* #  #  #  . .#  # $ ..#  #  . .#  #  # *.#
#$.$#* ##*$ #$# $* # * ####*  #$# $* ##*#*  #
# * #  #  #. ...#  # $ $ #  #. ...#  #  #   #
#  *#*## *$ #$. $*##  $*.# *$ #$# $*## *#$.*#
#   #  #  #. . .#  #### .#  #. . .#  #  # * #
#*.$#* # *##$#$##* ##### # *##$#$### # *#$. #
# * #   $ * * * *   * * * * * * * * . * # * #
# .$#*# #.    #  *# # # # #   #    $# # #$. #
# * #     #######           #######     # * #
# *  .# #$  #    $# ## ## #     #  .# #     #
#   # $ . * * * * . *   * * * * * * $ ###   #
### ## ################ ################# ###
  #     $ $ $ * $ * $     $ * $ * $ $     #
  ###  *.*.*.  *.*  .**  *.  *.*  .*.## ###
    #       *   $.  *    .$  .$   *     #
    #####################################
