###############
#  $  ..   $  #
#    #####    #
# @  #   #    #
#    *   #    #
###############
