##########
#@       #
#     $  #
# .      #
##########
